{
  "width": 10,
  "height": 10,
  "tiles": [
    "##########",
    "#....M...#",
    "#..M..M..#",
    "#........#",
    "#....@...#",
    "#........#",
    "#....!...#",
    "#........#",
    "#........#",
    "##########"
  ]
}
